ああ	abandon
あい	ability
あう	able
あえ	about
あお	above
あか	absent
あき	absorb
あく	abstract
あけ	absurd
あこ	abuse
あさ	access
あし	accident
あす	account
あせ	accuse
あそ	achieve
あた	acid
あち	acoustic
あつ	acquire
あて	across
あと	act
あな	action
あに	actor
あぬ	actress
あね	actual
あの	adapt
あは	add
あひ	addict
あふ	address
あへ	adjust
あほ	admit
あま	adult
あみ	advance
あむ	advice
あめ	aerobic
あも	affair
あや	afford
あゆ	afraid
あよ	again
あら	age
あり	agent
ある	agree
あれ	ahead
あろ	aim
あわ	air
あを	airport
あん	aisle
いあ	alarm
いい	album
いう	alcohol
いえ	alert
いお	alien
いか	all
いき	alley
いく	allow
いけ	almost
いこ	alone
いさ	alpha
いし	already
いす	also
いせ	alter
いそ	always
いた	amateur
いち	amazing
いつ	among
いて	amount
いと	amused
いな	analyst
いに	anchor
いぬ	ancient
いね	anger
いの	angle
いは	angry
いひ	animal
いふ	ankle
いへ	announce
いほ	annual
いま	another
いみ	answer
いむ	antenna
いめ	antique
いも	anxiety
いや	any
いゆ	apart
いよ	apology
いら	appear
いり	apple
いる	approve
いれ	april
いろ	arch
いわ	arctic
いを	area
いん	arena
うあ	argue
うい	arm
うう	armed
うえ	armor
うお	army
うか	around
うき	arrange
うく	arrest
うけ	arrive
うこ	arrow
うさ	art
うし	artefact
うす	artist
うせ	artwork
うそ	ask
うた	aspect
うち	assault
うつ	asset
うて	assist
うと	assume
うな	asthma
うに	athlete
うぬ	atom
うね	attack
うの	attend
うは	attitude
うひ	attract
うふ	auction
うへ	audit
うほ	august
うま	aunt
うみ	author
うむ	auto
うめ	autumn
うも	average
うや	avocado
うゆ	avoid
うよ	awake
うら	aware
うり	away
うる	awesome
うれ	awful
うろ	awkward
うわ	axis
うを	baby
うん	bachelor
えあ	bacon
えい	badge
えう	bag
ええ	balance
えお	balcony
えか	ball
えき	bamboo
えく	banana
えけ	banner
えこ	bar
えさ	barely
えし	bargain
えす	barrel
えせ	base
えそ	basic
えた	basket
えち	battle
えつ	beach
えて	bean
えと	beauty
えな	because
えに	become
えぬ	beef
えね	before
えの	begin
えは	behave
えひ	behind
えふ	believe
えへ	below
えほ	belt
えま	bench
えみ	benefit
えむ	best
えめ	betray
えも	better
えや	between
えゆ	beyond
えよ	bicycle
えら	bid
えり	bike
える	bind
えれ	biology
えろ	bird
えわ	birth
えを	bitter
えん	black
おあ	blade
おい	blame
おう	blanket
おえ	blast
おお	bleak
おか	bless
おき	blind
おく	blood
おけ	blossom
おこ	blouse
おさ	blue
おし	blur
おす	blush
おせ	board
おそ	boat
おた	body
おち	boil
おつ	bomb
おて	bone
おと	bonus
おな	book
おに	boost
おぬ	border
おね	boring
おの	borrow
おは	boss
おひ	bottom
おふ	bounce
おへ	box
おほ	boy
おま	bracket
おみ	brain
おむ	brand
おめ	brass
おも	brave
おや	bread
おゆ	breeze
およ	brick
おら	bridge
おり	brief
おる	bright
おれ	bring
おろ	brisk
おわ	broccoli
おを	broken
おん	bronze
かあ	broom
かい	brother
かう	brown
かえ	brush
かお	bubble
かか	buddy
かき	budget
かく	buffalo
かけ	build
かこ	bulb
かさ	bulk
かし	bullet
かす	bundle
かせ	bunker
かそ	burden
かた	burger
かち	burst
かつ	bus
かて	business
かと	busy
かな	butter
かに	buyer
かぬ	buzz
かね	cabbage
かの	cabin
かは	cable
かひ	cactus
かふ	cage
かへ	cake
かほ	call
かま	calm
かみ	camera
かむ	camp
かめ	can
かも	canal
かや	cancel
かゆ	candy
かよ	cannon
から	canoe
かり	canvas
かる	canyon
かれ	capable
かろ	capital
かわ	captain
かを	car
かん	carbon
きあ	card
きい	cargo
きう	carpet
きえ	carry
きお	cart
きか	case
きき	cash
きく	casino
きけ	castle
きこ	casual
きさ	cat
きし	catalog
きす	catch
きせ	category
きそ	cattle
きた	caught
きち	cause
きつ	caution
きて	cave
きと	ceiling
きな	celery
きに	cement
きぬ	census
きね	century
きの	cereal
きは	certain
きひ	chair
きふ	chalk
きへ	champion
きほ	change
きま	chaos
きみ	chapter
きむ	charge
きめ	chase
きも	chat
きや	cheap
きゆ	check
きよ	cheese
きら	chef
きり	cherry
きる	chest
きれ	chicken
きろ	chief
きわ	child
きを	chimney
きん	choice
くあ	choose
くい	chronic
くう	chuckle
くえ	chunk
くお	churn
くか	cigar
くき	cinnamon
くく	circle
くけ	citizen
くこ	city
くさ	civil
くし	claim
くす	clap
くせ	clarify
くそ	claw
くた	clay
くち	clean
くつ	clerk
くて	clever
くと	click
くな	client
くに	cliff
くぬ	climb
くね	clinic
くの	clip
くは	clock
くひ	clog
くふ	close
くへ	cloth
くほ	cloud
くま	clown
くみ	club
くむ	clump
くめ	cluster
くも	clutch
くや	coach
くゆ	coast
くよ	coconut
くら	code
くり	coffee
くる	coil
くれ	coin
くろ	collect
くわ	color
くを	column
くん	combine
けあ	come
けい	comfort
けう	comic
けえ	common
けお	company
けか	concert
けき	conduct
けく	confirm
けけ	congress
けこ	connect
けさ	consider
けし	control
けす	convince
けせ	cook
けそ	cool
けた	copper
けち	copy
けつ	coral
けて	core
けと	corn
けな	correct
けに	cost
けぬ	cotton
けね	couch
けの	country
けは	couple
けひ	course
けふ	cousin
けへ	cover
けほ	coyote
けま	crack
けみ	cradle
けむ	craft
けめ	cram
けも	crane
けや	crash
けゆ	crater
けよ	crawl
けら	crazy
けり	cream
ける	credit
けれ	creek
けろ	crew
けわ	cricket
けを	crime
けん	crisp
こあ	critic
こい	crop
こう	cross
こえ	crouch
こお	crowd
こか	crucial
こき	cruel
こく	cruise
こけ	crumble
ここ	crunch
こさ	crush
こし	cry
こす	crystal
こせ	cube
こそ	culture
こた	cup
こち	cupboard
こつ	curious
こて	current
こと	curtain
こな	curve
こに	cushion
こぬ	custom
こね	cute
この	cycle
こは	dad
こひ	damage
こふ	damp
こへ	dance
こほ	danger
こま	daring
こみ	dash
こむ	daughter
こめ	dawn
こも	day
こや	deal
こゆ	debate
こよ	debris
こら	decade
こり	december
こる	decide
これ	decline
ころ	decorate
こわ	decrease
こを	deer
こん	defense
さあ	define
さい	defy
さう	degree
さえ	delay
さお	deliver
さか	demand
さき	demise
さく	denial
さけ	dentist
さこ	deny
ささ	depart
さし	depend
さす	deposit
させ	depth
さそ	deputy
さた	derive
さち	describe
さつ	desert
さて	design
さと	desk
さな	despair
さに	destroy
さぬ	detail
さね	detect
さの	develop
さは	device
さひ	devote
さふ	diagram
さへ	dial
さほ	diamond
さま	diary
さみ	dice
さむ	diesel
さめ	diet
さも	differ
さや	digital
さゆ	dignity
さよ	dilemma
さら	dinner
さり	dinosaur
さる	direct
され	dirt
さろ	disagree
さわ	discover
さを	disease
さん	dish
しあ	dismiss
しい	disorder
しう	display
しえ	distance
しお	divert
しか	divide
しき	divorce
しく	dizzy
しけ	doctor
しこ	document
しさ	dog
しし	doll
しす	dolphin
しせ	domain
しそ	donate
した	donkey
しち	donor
しつ	door
して	dose
しと	double
しな	dove
しに	draft
しぬ	dragon
しね	drama
しの	drastic
しは	draw
しひ	dream
しふ	dress
しへ	drift
しほ	drill
しま	drink
しみ	drip
しむ	drive
しめ	drop
しも	drum
しや	dry
しゆ	duck
しよ	dumb
しら	dune
しり	during
しる	dust
しれ	dutch
しろ	duty
しわ	dwarf
しを	dynamic
しん	eager
すあ	eagle
すい	early
すう	earn
すえ	earth
すお	easily
すか	east
すき	easy
すく	echo
すけ	ecology
すこ	economy
すさ	edge
すし	edit
すす	educate
すせ	effort
すそ	egg
すた	eight
すち	either
すつ	elbow
すて	elder
すと	electric
すな	elegant
すに	element
すぬ	elephant
すね	elevator
すの	elite
すは	else
すひ	embark
すふ	embody
すへ	embrace
すほ	emerge
すま	emotion
すみ	employ
すむ	empower
すめ	empty
すも	enable
すや	enact
すゆ	end
すよ	endless
すら	endorse
すり	enemy
する	energy
すれ	enforce
すろ	engage
すわ	engine
すを	enhance
すん	enjoy
せあ	enlist
せい	enough
せう	enrich
せえ	enroll
せお	ensure
せか	enter
せき	entire
せく	entry
せけ	envelope
せこ	episode
せさ	equal
せし	equip
せす	era
せせ	erase
せそ	erode
せた	erosion
せち	error
せつ	erupt
せて	escape
せと	essay
せな	essence
せに	estate
せぬ	eternal
せね	ethics
せの	evidence
せは	evil
せひ	evoke
せふ	evolve
せへ	exact
せほ	example
せま	excess
せみ	exchange
せむ	excite
せめ	exclude
せも	excuse
せや	execute
せゆ	exercise
せよ	exhaust
せら	exhibit
せり	exile
せる	exist
せれ	exit
せろ	exotic
せわ	expand
せを	expect
せん	expire
そあ	explain
そい	expose
そう	express
そえ	extend
そお	extra
そか	eye
そき	eyebrow
そく	fabric
そけ	face
そこ	faculty
そさ	fade
そし	faint
そす	faith
そせ	fall
そそ	false
そた	fame
そち	family
そつ	famous
そて	fan
そと	fancy
そな	fantasy
そに	farm
そぬ	fashion
そね	fat
その	fatal
そは	father
そひ	fatigue
そふ	fault
そへ	favorite
そほ	feature
そま	february
そみ	federal
そむ	fee
そめ	feed
そも	feel
そや	female
そゆ	fence
そよ	festival
そら	fetch
そり	fever
そる	few
それ	fiber
そろ	fiction
そわ	field
そを	figure
そん	file
たあ	film
たい	filter
たう	final
たえ	find
たお	fine
たか	finger
たき	finish
たく	fire
たけ	firm
たこ	first
たさ	fiscal
たし	fish
たす	fit
たせ	fitness
たそ	fix
たた	flag
たち	flame
たつ	flash
たて	flat
たと	flavor
たな	flee
たに	flight
たぬ	flip
たね	float
たの	flock
たは	floor
たひ	flower
たふ	fluid
たへ	flush
たほ	fly
たま	foam
たみ	focus
たむ	fog
ため	foil
たも	fold
たや	follow
たゆ	food
たよ	foot
たら	force
たり	forest
たる	forget
たれ	fork
たろ	fortune
たわ	forum
たを	forward
たん	fossil
ちあ	foster
ちい	found
ちう	fox
ちえ	fragile
ちお	frame
ちか	frequent
ちき	fresh
ちく	friend
ちけ	fringe
ちこ	frog
ちさ	front
ちし	frost
ちす	frown
ちせ	frozen
ちそ	fruit
ちた	fuel
ちち	fun
ちつ	funny
ちて	furnace
ちと	fury
ちな	future
ちに	gadget
ちぬ	gain
ちね	galaxy
ちの	gallery
ちは	game
ちひ	gap
ちふ	garage
ちへ	garbage
ちほ	garden
ちま	garlic
ちみ	garment
ちむ	gas
ちめ	gasp
ちも	gate
ちや	gather
ちゆ	gauge
ちよ	gaze
ちら	general
ちり	genius
ちる	genre
ちれ	gentle
ちろ	genuine
ちわ	gesture
ちを	ghost
ちん	giant
つあ	gift
つい	giggle
つう	ginger
つえ	giraffe
つお	girl
つか	give
つき	glad
つく	glance
つけ	glare
つこ	glass
つさ	glide
つし	glimpse
つす	globe
つせ	gloom
つそ	glory
つた	glove
つち	glow
つつ	glue
つて	goat
つと	goddess
つな	gold
つに	good
つぬ	goose
つね	gorilla
つの	gospel
つは	gossip
つひ	govern
つふ	gown
つへ	grab
つほ	grace
つま	grain
つみ	grant
つむ	grape
つめ	grass
つも	gravity
つや	great
つゆ	green
つよ	grid
つら	grief
つり	grit
つる	grocery
つれ	group
つろ	grow
つわ	grunt
つを	guard
つん	guess
てあ	guide
てい	guilt
てう	guitar
てえ	gun
てお	gym
てか	habit
てき	hair
てく	half
てけ	hammer
てこ	hamster
てさ	hand
てし	happy
てす	harbor
てせ	hard
てそ	harsh
てた	harvest
てち	hat
てつ	have
てて	hawk
てと	hazard
てな	head
てに	health
てぬ	heart
てね	heavy
ての	hedgehog
ては	height
てひ	hello
てふ	helmet
てへ	help
てほ	hen
てま	hero
てみ	hidden
てむ	high
てめ	hill
ても	hint
てや	hip
てゆ	hire
てよ	history
てら	hobby
てり	hockey
てる	hold
てれ	hole
てろ	holiday
てわ	hollow
てを	home
てん	honey
とあ	hood
とい	hope
とう	horn
とえ	horror
とお	horse
とか	hospital
とき	host
とく	hotel
とけ	hour
とこ	hover
とさ	hub
とし	huge
とす	human
とせ	humble
とそ	humor
とた	hundred
とち	hungry
とつ	hunt
とて	hurdle
とと	hurry
とな	hurt
とに	husband
とぬ	hybrid
とね	ice
との	icon
とは	idea
とひ	identify
とふ	idle
とへ	ignore
とほ	ill
とま	illegal
とみ	illness
とむ	image
とめ	imitate
とも	immense
とや	immune
とゆ	impact
とよ	impose
とら	improve
とり	impulse
とる	inch
とれ	include
とろ	income
とわ	increase
とを	index
とん	indicate
なあ	indoor
ない	industry
なう	infant
なえ	inflict
なお	inform
なか	inhale
なき	inherit
なく	initial
なけ	inject
なこ	injury
なさ	inmate
なし	inner
なす	innocent
なせ	input
なそ	inquiry
なた	insane
なち	insect
なつ	inside
なて	inspire
なと	install
なな	intact
なに	interest
なぬ	into
なね	invest
なの	invite
なは	involve
なひ	iron
なふ	island
なへ	isolate
なほ	issue
なま	item
なみ	ivory
なむ	jacket
なめ	jaguar
なも	jar
なや	jazz
なゆ	jealous
なよ	jeans
なら	jelly
なり	jewel
なる	job
なれ	join
なろ	joke
なわ	journey
なを	joy
なん	judge
にあ	juice
にい	jump
にう	jungle
にえ	junior
にお	junk
にか	just
にき	kangaroo
にく	keen
にけ	keep
にこ	ketchup
にさ	key
にし	kick
にす	kid
にせ	kidney
にそ	kind
にた	kingdom
にち	kiss
につ	kit
にて	kitchen
にと	kite
にな	kitten
にに	kiwi
にぬ	knee
にね	knife
にの	knock
には	know
にひ	lab
にふ	label
にへ	labor
にほ	ladder
にま	lady
にみ	lake
にむ	lamp
にめ	language
にも	laptop
にや	large
にゆ	later
によ	latin
にら	laugh
にり	laundry
にる	lava
にれ	law
にろ	lawn
にわ	lawsuit
にを	layer
にん	lazy
ぬあ	leader
ぬい	leaf
ぬう	learn
ぬえ	leave
ぬお	lecture
ぬか	left
ぬき	leg
ぬく	legal
ぬけ	legend
ぬこ	leisure
ぬさ	lemon
ぬし	lend
ぬす	length
ぬせ	lens
ぬそ	leopard
ぬた	lesson
ぬち	letter
ぬつ	level
ぬて	liar
ぬと	liberty
ぬな	library
ぬに	license
ぬぬ	life
ぬね	lift
ぬの	light
ぬは	like
ぬひ	limb
ぬふ	limit
ぬへ	link
ぬほ	lion
ぬま	liquid
ぬみ	list
ぬむ	little
ぬめ	live
ぬも	lizard
ぬや	load
ぬゆ	loan
ぬよ	lobster
ぬら	local
ぬり	lock
ぬる	logic
ぬれ	lonely
ぬろ	long
ぬわ	loop
ぬを	lottery
ぬん	loud
ねあ	lounge
ねい	love
ねう	loyal
ねえ	lucky
ねお	luggage
ねか	lumber
ねき	lunar
ねく	lunch
ねけ	luxury
ねこ	lyrics
ねさ	machine
ねし	mad
ねす	magic
ねせ	magnet
ねそ	maid
ねた	mail
ねち	main
ねつ	major
ねて	make
ねと	mammal
ねな	man
ねに	manage
ねぬ	mandate
ねね	mango
ねの	mansion
ねは	manual
ねひ	maple
ねふ	marble
ねへ	march
ねほ	margin
ねま	marine
ねみ	market
ねむ	marriage
ねめ	mask
ねも	mass
ねや	master
ねゆ	match
ねよ	material
ねら	math
ねり	matrix
ねる	matter
ねれ	maximum
ねろ	maze
ねわ	meadow
ねを	mean
ねん	measure
のあ	meat
のい	mechanic
のう	medal
のえ	media
のお	melody
のか	melt
のき	member
のく	memory
のけ	mention
のこ	menu
のさ	mercy
のし	merge
のす	merit
のせ	merry
のそ	mesh
のた	message
のち	metal
のつ	method
のて	middle
のと	midnight
のな	milk
のに	million
のぬ	mimic
のね	mind
のの	minimum
のは	minor
のひ	minute
のふ	miracle
のへ	mirror
のほ	misery
のま	miss
のみ	mistake
のむ	mix
のめ	mixed
のも	mixture
のや	mobile
のゆ	model
のよ	modify
のら	mom
のり	moment
のる	monitor
のれ	monkey
のろ	monster
のわ	month
のを	moon
のん	moral
はあ	more
はい	morning
はう	mosquito
はえ	mother
はお	motion
はか	motor
はき	mountain
はく	mouse
はけ	move
はこ	movie
はさ	much
はし	muffin
はす	mule
はせ	multiply
はそ	muscle
はた	museum
はち	mushroom
はつ	music
はて	must
はと	mutual
はな	myself
はに	mystery
はぬ	myth
はね	naive
はの	name
はは	napkin
はひ	narrow
はふ	nasty
はへ	nation
はほ	nature
はま	near
はみ	neck
はむ	need
はめ	negative
はも	neglect
はや	neither
はゆ	nephew
はよ	nerve
はら	nest
はり	net
はる	network
はれ	neutral
はろ	never
はわ	news
はを	next
はん	nice
ひあ	night
ひい	noble
ひう	noise
ひえ	nominee
ひお	noodle
ひか	normal
ひき	north
ひく	nose
ひけ	notable
ひこ	note
ひさ	nothing
ひし	notice
ひす	novel
ひせ	now
ひそ	nuclear
ひた	number
ひち	nurse
ひつ	nut
ひて	oak
ひと	obey
ひな	object
ひに	oblige
ひぬ	obscure
ひね	observe
ひの	obtain
ひは	obvious
ひひ	occur
ひふ	ocean
ひへ	october
ひほ	odor
ひま	off
ひみ	offer
ひむ	office
ひめ	often
ひも	oil
ひや	okay
ひゆ	old
ひよ	olive
ひら	olympic
ひり	omit
ひる	once
ひれ	one
ひろ	onion
ひわ	online
ひを	only
ひん	open
ふあ	opera
ふい	opinion
ふう	oppose
ふえ	option
ふお	orange
ふか	orbit
ふき	orchard
ふく	order
ふけ	ordinary
ふこ	organ
ふさ	orient
ふし	original
ふす	orphan
ふせ	ostrich
ふそ	other
ふた	outdoor
ふち	outer
ふつ	output
ふて	outside
ふと	oval
ふな	oven
ふに	over
ふぬ	own
ふね	owner
ふの	oxygen
ふは	oyster
ふひ	ozone
ふふ	pact
ふへ	paddle
ふほ	page
ふま	pair
ふみ	palace
ふむ	palm
ふめ	panda
ふも	panel
ふや	panic
ふゆ	panther
ふよ	paper
ふら	parade
ふり	parent
ふる	park
ふれ	parrot
ふろ	party
ふわ	pass
ふを	patch
ふん	path
へあ	patient
へい	patrol
へう	pattern
へえ	pause
へお	pave
へか	payment
へき	peace
へく	peanut
へけ	pear
へこ	peasant
へさ	pelican
へし	pen
へす	penalty
へせ	pencil
へそ	people
へた	pepper
へち	perfect
へつ	permit
へて	person
へと	pet
へな	phone
へに	photo
へぬ	phrase
へね	physical
への	piano
へは	picnic
へひ	picture
へふ	piece
へへ	pig
へほ	pigeon
へま	pill
へみ	pilot
へむ	pink
へめ	pioneer
へも	pipe
へや	pistol
へゆ	pitch
へよ	pizza
へら	place
へり	planet
へる	plastic
へれ	plate
へろ	play
へわ	please
へを	pledge
へん	pluck
ほあ	plug
ほい	plunge
ほう	poem
ほえ	poet
ほお	point
ほか	polar
ほき	pole
ほく	police
ほけ	pond
ほこ	pony
ほさ	pool
ほし	popular
ほす	portion
ほせ	position
ほそ	possible
ほた	post
ほち	potato
ほつ	pottery
ほて	poverty
ほと	powder
ほな	power
ほに	practice
ほぬ	praise
ほね	predict
ほの	prefer
ほは	prepare
ほひ	present
ほふ	pretty
ほへ	prevent
ほほ	price
ほま	pride
ほみ	primary
ほむ	print
ほめ	priority
ほも	prison
ほや	private
ほゆ	prize
ほよ	problem
ほら	process
ほり	produce
ほる	profit
ほれ	program
ほろ	project
ほわ	promote
ほを	proof
ほん	property
まあ	prosper
まい	protect
まう	proud
まえ	provide
まお	public
まか	pudding
まき	pull
まく	pulp
まけ	pulse
まこ	pumpkin
まさ	punch
まし	pupil
ます	puppy
ませ	purchase
まそ	purity
また	purpose
まち	purse
まつ	push
まて	put
まと	puzzle
まな	pyramid
まに	quality
まぬ	quantum
まね	quarter
まの	question
まは	quick
まひ	quit
まふ	quiz
まへ	quote
まほ	rabbit
まま	raccoon
まみ	race
まむ	rack
まめ	radar
まも	radio
まや	rail
まゆ	rain
まよ	raise
まら	rally
まり	ramp
まる	ranch
まれ	random
まろ	range
まわ	rapid
まを	rare
まん	rate
みあ	rather
みい	raven
みう	raw
みえ	razor
みお	ready
みか	real
みき	reason
みく	rebel
みけ	rebuild
みこ	recall
みさ	receive
みし	recipe
みす	record
みせ	recycle
みそ	reduce
みた	reflect
みち	reform
みつ	refuse
みて	region
みと	regret
みな	regular
みに	reject
みぬ	relax
みね	release
みの	relief
みは	rely
みひ	remain
みふ	remember
みへ	remind
みほ	remove
みま	render
みみ	renew
みむ	rent
みめ	reopen
みも	repair
みや	repeat
みゆ	replace
みよ	report
みら	require
みり	rescue
みる	resemble
みれ	resist
みろ	resource
みわ	response
みを	result
みん	retire
むあ	retreat
むい	return
むう	reunion
むえ	reveal
むお	review
むか	reward
むき	rhythm
むく	rib
むけ	ribbon
むこ	rice
むさ	rich
むし	ride
むす	ridge
むせ	rifle
むそ	right
むた	rigid
むち	ring
むつ	riot
むて	ripple
むと	risk
むな	ritual
むに	rival
むぬ	river
むね	road
むの	roast
むは	robot
むひ	robust
むふ	rocket
むへ	romance
むほ	roof
むま	rookie
むみ	room
むむ	rose
むめ	rotate
むも	rough
むや	round
むゆ	route
むよ	royal
むら	rubber
むり	rude
むる	rug
むれ	rule
むろ	run
むわ	runway
むを	rural
むん	sad
めあ	saddle
めい	sadness
めう	safe
めえ	sail
めお	salad
めか	salmon
めき	salon
めく	salt
めけ	salute
めこ	same
めさ	sample
めし	sand
めす	satisfy
めせ	satoshi
めそ	sauce
めた	sausage
めち	save
めつ	say
めて	scale
めと	scan
めな	scare
めに	scatter
めぬ	scene
めね	scheme
めの	school
めは	science
めひ	scissors
めふ	scorpion
めへ	scout
めほ	scrap
めま	screen
めみ	script
めむ	scrub
めめ	sea
めも	search
めや	season
めゆ	seat
めよ	second
めら	secret
めり	section
める	security
めれ	seed
めろ	seek
めわ	segment
めを	select
めん	sell
もあ	seminar
もい	senior
もう	sense
もえ	sentence
もお	series
もか	service
もき	session
もく	settle
もけ	setup
もこ	seven
もさ	shadow
もし	shaft
もす	shallow
もせ	share
もそ	shed
もた	shell
もち	sheriff
もつ	shield
もて	shift
もと	shine
もな	ship
もに	shiver
もぬ	shock
もね	shoe
もの	shoot
もは	shop
もひ	short
もふ	shoulder
もへ	shove
もほ	shrimp
もま	shrug
もみ	shuffle
もむ	shy
もめ	sibling
もも	sick
もや	side
もゆ	siege
もよ	sight
もら	sign
もり	silent
もる	silk
もれ	silly
もろ	silver
もわ	similar
もを	simple
もん	since
やあ	sing
やい	siren
やう	sister
やえ	situate
やお	six
やか	size
やき	skate
やく	sketch
やけ	ski
やこ	skill
やさ	skin
やし	skirt
やす	skull
やせ	slab
やそ	slam
やた	sleep
やち	slender
やつ	slice
やて	slide
やと	slight
やな	slim
やに	slogan
やぬ	slot
やね	slow
やの	slush
やは	small
やひ	smart
やふ	smile
やへ	smoke
やほ	smooth
やま	snack
やみ	snake
やむ	snap
やめ	sniff
やも	snow
やや	soap
やゆ	soccer
やよ	social
やら	sock
やり	soda
やる	soft
やれ	solar
やろ	soldier
やわ	solid
やを	solution
やん	solve
ゆあ	someone
ゆい	song
ゆう	soon
ゆえ	sorry
ゆお	sort
ゆか	soul
ゆき	sound
ゆく	soup
ゆけ	source
ゆこ	south
ゆさ	space
ゆし	spare
ゆす	spatial
ゆせ	spawn
ゆそ	speak
ゆた	special
ゆち	speed
ゆつ	spell
ゆて	spend
ゆと	sphere
ゆな	spice
ゆに	spider
ゆぬ	spike
ゆね	spin
ゆの	spirit
ゆは	split
ゆひ	spoil
ゆふ	sponsor
ゆへ	spoon
ゆほ	sport
ゆま	spot
ゆみ	spray
ゆむ	spread
ゆめ	spring
ゆも	spy
ゆや	square
ゆゆ	squeeze
ゆよ	squirrel
ゆら	stable
ゆり	stadium
ゆる	staff
ゆれ	stage
ゆろ	stairs
ゆわ	stamp
ゆを	stand
ゆん	start
よあ	state
よい	stay
よう	steak
よえ	steel
よお	stem
よか	step
よき	stereo
よく	stick
よけ	still
よこ	sting
よさ	stock
よし	stomach
よす	stone
よせ	stool
よそ	story
よた	stove
よち	strategy
よつ	street
よて	strike
よと	strong
よな	struggle
よに	student
よぬ	stuff
よね	stumble
よの	style
よは	subject
よひ	submit
よふ	subway
よへ	success
よほ	such
よま	sudden
よみ	suffer
よむ	sugar
よめ	suggest
よも	suit
よや	summer
よゆ	sun
よよ	sunny
よら	sunset
より	super
よる	supply
よれ	supreme
よろ	sure
よわ	surface
よを	surge
よん	surprise
らあ	surround
らい	survey
らう	suspect
らえ	sustain
らお	swallow
らか	swamp
らき	swap
らく	swarm
らけ	swear
らこ	sweet
らさ	swift
らし	swim
らす	swing
らせ	switch
らそ	sword
らた	symbol
らち	symptom
らつ	syrup
らて	system
らと	table
らな	tackle
らに	tag
らぬ	tail
らね	talent
らの	talk
らは	tank
らひ	tape
らふ	target
らへ	task
らほ	taste
らま	tattoo
らみ	taxi
らむ	teach
らめ	team
らも	tell
らや	ten
らゆ	tenant
らよ	tennis
らら	tent
らり	term
らる	test
られ	text
らろ	thank
らわ	that
らを	theme
らん	then
りあ	theory
りい	there
りう	they
りえ	thing
りお	this
りか	thought
りき	three
りく	thrive
りけ	throw
りこ	thumb
りさ	thunder
りし	ticket
りす	tide
りせ	tiger
りそ	tilt
りた	timber
りち	time
りつ	tiny
りて	tip
りと	tired
りな	tissue
りに	title
りぬ	toast
りね	tobacco
りの	today
りは	toddler
りひ	toe
りふ	together
りへ	toilet
りほ	token
りま	tomato
りみ	tomorrow
りむ	tone
りめ	tongue
りも	tonight
りや	tool
りゆ	tooth
りよ	top
りら	topic
りり	topple
りる	torch
りれ	tornado
りろ	tortoise
りわ	toss
りを	total
りん	tourist
るあ	toward
るい	tower
るう	town
るえ	toy
るお	track
るか	trade
るき	traffic
るく	tragic
るけ	train
るこ	transfer
るさ	trap
るし	trash
るす	travel
るせ	tray
るそ	treat
るた	tree
るち	trend
るつ	trial
るて	tribe
ると	trick
るな	trigger
るに	trim
るぬ	trip
るね	trophy
るの	trouble
るは	truck
るひ	true
るふ	truly
るへ	trumpet
るほ	trust
るま	truth
るみ	try
るむ	tube
るめ	tuition
るも	tumble
るや	tuna
るゆ	tunnel
るよ	turkey
るら	turn
るり	turtle
るる	twelve
るれ	twenty
るろ	twice
るわ	twin
るを	twist
るん	two
れあ	type
れい	typical
れう	ugly
れえ	umbrella
れお	unable
れか	unaware
れき	uncle
れく	uncover
れけ	under
れこ	undo
れさ	unfair
れし	unfold
れす	unhappy
れせ	uniform
れそ	unique
れた	unit
れち	universe
れつ	unknown
れて	unlock
れと	until
れな	unusual
れに	unveil
れぬ	update
れね	upgrade
れの	uphold
れは	upon
れひ	upper
れふ	upset
れへ	urban
れほ	urge
れま	usage
れみ	use
れむ	used
れめ	useful
れも	useless
れや	usual
れゆ	utility
れよ	vacant
れら	vacuum
れり	vague
れる	valid
れれ	valley
れろ	valve
れわ	van
れを	vanish
れん	vapor
ろあ	various
ろい	vast
ろう	vault
ろえ	vehicle
ろお	velvet
ろか	vendor
ろき	venture
ろく	venue
ろけ	verb
ろこ	verify
ろさ	version
ろし	very
ろす	vessel
ろせ	veteran
ろそ	viable
ろた	vibrant
ろち	vicious
ろつ	victory
ろて	video
ろと	view
ろな	village
ろに	vintage
ろぬ	violin
ろね	virtual
ろの	virus
ろは	visa
ろひ	visit
ろふ	visual
ろへ	vital
ろほ	vivid
ろま	vocal
ろみ	voice
ろむ	void
ろめ	volcano
ろも	volume
ろや	vote
ろゆ	voyage
ろよ	wage
ろら	wagon
ろり	wait
ろる	walk
ろれ	wall
ろろ	walnut
ろわ	want
ろを	warfare
ろん	warm
わあ	warrior
わい	wash
わう	wasp
わえ	waste
わお	water
わか	wave
わき	way
わく	wealth
わけ	weapon
わこ	wear
わさ	weasel
わし	weather
わす	web
わせ	wedding
わそ	weekend
わた	weird
わち	welcome
わつ	west
わて	wet
わと	whale
わな	what
わに	wheat
わぬ	wheel
わね	when
わの	where
わは	whip
わひ	whisper
わふ	wide
わへ	width
わほ	wife
わま	wild
わみ	will
わむ	win
わめ	window
わも	wine
わや	wing
わゆ	wink
わよ	winner
わら	winter
わり	wire
わる	wisdom
われ	wise
わろ	wish
わわ	witness
わを	wolf
わん	woman
をあ	wonder
をい	wood
をう	wool
をえ	word
をお	work
をか	world
をき	worry
をく	worth
をけ	wrap
をこ	wreck
をさ	wrestle
をし	wrist
をす	write
をせ	wrong
をそ	yard
をた	year
をち	yellow
をつ	you
をて	young
をと	youth
をな	zebra
をに	zero
をぬ	zone
をね	zoo
