アア	abandon
アイ	ability
アウ	able
アエ	about
アオ	above
アカ	absent
アキ	absorb
アク	abstract
アケ	absurd
アコ	abuse
アサ	access
アシ	accident
アス	account
アセ	accuse
アソ	achieve
アタ	acid
アチ	acoustic
アツ	acquire
アテ	across
アト	act
アナ	action
アニ	actor
アヌ	actress
アネ	actual
アノ	adapt
アハ	add
アヒ	addict
アフ	address
アヘ	adjust
アホ	admit
アマ	adult
アミ	advance
アム	advice
アメ	aerobic
アモ	affair
アヤ	afford
アユ	afraid
アヨ	again
アラ	age
アリ	agent
アル	agree
アレ	ahead
アロ	aim
アワ	air
アヲ	airport
アン	aisle
イア	alarm
イイ	album
イウ	alcohol
イエ	alert
イオ	alien
イカ	all
イキ	alley
イク	allow
イケ	almost
イコ	alone
イサ	alpha
イシ	already
イス	also
イセ	alter
イソ	always
イタ	amateur
イチ	amazing
イツ	among
イテ	amount
イト	amused
イナ	analyst
イニ	anchor
イヌ	ancient
イネ	anger
イノ	angle
イハ	angry
イヒ	animal
イフ	ankle
イヘ	announce
イホ	annual
イマ	another
イミ	answer
イム	antenna
イメ	antique
イモ	anxiety
イヤ	any
イユ	apart
イヨ	apology
イラ	appear
イリ	apple
イル	approve
イレ	april
イロ	arch
イワ	arctic
イヲ	area
イン	arena
ウア	argue
ウイ	arm
ウウ	armed
ウエ	armor
ウオ	army
ウカ	around
ウキ	arrange
ウク	arrest
ウケ	arrive
ウコ	arrow
ウサ	art
ウシ	artefact
ウス	artist
ウセ	artwork
ウソ	ask
ウタ	aspect
ウチ	assault
ウツ	asset
ウテ	assist
ウト	assume
ウナ	asthma
ウニ	athlete
ウヌ	atom
ウネ	attack
ウノ	attend
ウハ	attitude
ウヒ	attract
ウフ	auction
ウヘ	audit
ウホ	august
ウマ	aunt
ウミ	author
ウム	auto
ウメ	autumn
ウモ	average
ウヤ	avocado
ウユ	avoid
ウヨ	awake
ウラ	aware
ウリ	away
ウル	awesome
ウレ	awful
ウロ	awkward
ウワ	axis
ウヲ	baby
ウン	bachelor
エア	bacon
エイ	badge
エウ	bag
エエ	balance
エオ	balcony
エカ	ball
エキ	bamboo
エク	banana
エケ	banner
エコ	bar
エサ	barely
エシ	bargain
エス	barrel
エセ	base
エソ	basic
エタ	basket
エチ	battle
エツ	beach
エテ	bean
エト	beauty
エナ	because
エニ	become
エヌ	beef
エネ	before
エノ	begin
エハ	behave
エヒ	behind
エフ	believe
エヘ	below
エホ	belt
エマ	bench
エミ	benefit
エム	best
エメ	betray
エモ	better
エヤ	between
エユ	beyond
エヨ	bicycle
エラ	bid
エリ	bike
エル	bind
エレ	biology
エロ	bird
エワ	birth
エヲ	bitter
エン	black
オア	blade
オイ	blame
オウ	blanket
オエ	blast
オオ	bleak
オカ	bless
オキ	blind
オク	blood
オケ	blossom
オコ	blouse
オサ	blue
オシ	blur
オス	blush
オセ	board
オソ	boat
オタ	body
オチ	boil
オツ	bomb
オテ	bone
オト	bonus
オナ	book
オニ	boost
オヌ	border
オネ	boring
オノ	borrow
オハ	boss
オヒ	bottom
オフ	bounce
オヘ	box
オホ	boy
オマ	bracket
オミ	brain
オム	brand
オメ	brass
オモ	brave
オヤ	bread
オユ	breeze
オヨ	brick
オラ	bridge
オリ	brief
オル	bright
オレ	bring
オロ	brisk
オワ	broccoli
オヲ	broken
オン	bronze
カア	broom
カイ	brother
カウ	brown
カエ	brush
カオ	bubble
カカ	buddy
カキ	budget
カク	buffalo
カケ	build
カコ	bulb
カサ	bulk
カシ	bullet
カス	bundle
カセ	bunker
カソ	burden
カタ	burger
カチ	burst
カツ	bus
カテ	business
カト	busy
カナ	butter
カニ	buyer
カヌ	buzz
カネ	cabbage
カノ	cabin
カハ	cable
カヒ	cactus
カフ	cage
カヘ	cake
カホ	call
カマ	calm
カミ	camera
カム	camp
カメ	can
カモ	canal
カヤ	cancel
カユ	candy
カヨ	cannon
カラ	canoe
カリ	canvas
カル	canyon
カレ	capable
カロ	capital
カワ	captain
カヲ	car
カン	carbon
キア	card
キイ	cargo
キウ	carpet
キエ	carry
キオ	cart
キカ	case
キキ	cash
キク	casino
キケ	castle
キコ	casual
キサ	cat
キシ	catalog
キス	catch
キセ	category
キソ	cattle
キタ	caught
キチ	cause
キツ	caution
キテ	cave
キト	ceiling
キナ	celery
キニ	cement
キヌ	census
キネ	century
キノ	cereal
キハ	certain
キヒ	chair
キフ	chalk
キヘ	champion
キホ	change
キマ	chaos
キミ	chapter
キム	charge
キメ	chase
キモ	chat
キヤ	cheap
キユ	check
キヨ	cheese
キラ	chef
キリ	cherry
キル	chest
キレ	chicken
キロ	chief
キワ	child
キヲ	chimney
キン	choice
クア	choose
クイ	chronic
クウ	chuckle
クエ	chunk
クオ	churn
クカ	cigar
クキ	cinnamon
クク	circle
クケ	citizen
クコ	city
クサ	civil
クシ	claim
クス	clap
クセ	clarify
クソ	claw
クタ	clay
クチ	clean
クツ	clerk
クテ	clever
クト	click
クナ	client
クニ	cliff
クヌ	climb
クネ	clinic
クノ	clip
クハ	clock
クヒ	clog
クフ	close
クヘ	cloth
クホ	cloud
クマ	clown
クミ	club
クム	clump
クメ	cluster
クモ	clutch
クヤ	coach
クユ	coast
クヨ	coconut
クラ	code
クリ	coffee
クル	coil
クレ	coin
クロ	collect
クワ	color
クヲ	column
クン	combine
ケア	come
ケイ	comfort
ケウ	comic
ケエ	common
ケオ	company
ケカ	concert
ケキ	conduct
ケク	confirm
ケケ	congress
ケコ	connect
ケサ	consider
ケシ	control
ケス	convince
ケセ	cook
ケソ	cool
ケタ	copper
ケチ	copy
ケツ	coral
ケテ	core
ケト	corn
ケナ	correct
ケニ	cost
ケヌ	cotton
ケネ	couch
ケノ	country
ケハ	couple
ケヒ	course
ケフ	cousin
ケヘ	cover
ケホ	coyote
ケマ	crack
ケミ	cradle
ケム	craft
ケメ	cram
ケモ	crane
ケヤ	crash
ケユ	crater
ケヨ	crawl
ケラ	crazy
ケリ	cream
ケル	credit
ケレ	creek
ケロ	crew
ケワ	cricket
ケヲ	crime
ケン	crisp
コア	critic
コイ	crop
コウ	cross
コエ	crouch
コオ	crowd
コカ	crucial
コキ	cruel
コク	cruise
コケ	crumble
ココ	crunch
コサ	crush
コシ	cry
コス	crystal
コセ	cube
コソ	culture
コタ	cup
コチ	cupboard
コツ	curious
コテ	current
コト	curtain
コナ	curve
コニ	cushion
コヌ	custom
コネ	cute
コノ	cycle
コハ	dad
コヒ	damage
コフ	damp
コヘ	dance
コホ	danger
コマ	daring
コミ	dash
コム	daughter
コメ	dawn
コモ	day
コヤ	deal
コユ	debate
コヨ	debris
コラ	decade
コリ	december
コル	decide
コレ	decline
コロ	decorate
コワ	decrease
コヲ	deer
コン	defense
サア	define
サイ	defy
サウ	degree
サエ	delay
サオ	deliver
サカ	demand
サキ	demise
サク	denial
サケ	dentist
サコ	deny
ササ	depart
サシ	depend
サス	deposit
サセ	depth
サソ	deputy
サタ	derive
サチ	describe
サツ	desert
サテ	design
サト	desk
サナ	despair
サニ	destroy
サヌ	detail
サネ	detect
サノ	develop
サハ	device
サヒ	devote
サフ	diagram
サヘ	dial
サホ	diamond
サマ	diary
サミ	dice
サム	diesel
サメ	diet
サモ	differ
サヤ	digital
サユ	dignity
サヨ	dilemma
サラ	dinner
サリ	dinosaur
サル	direct
サレ	dirt
サロ	disagree
サワ	discover
サヲ	disease
サン	dish
シア	dismiss
シイ	disorder
シウ	display
シエ	distance
シオ	divert
シカ	divide
シキ	divorce
シク	dizzy
シケ	doctor
シコ	document
シサ	dog
シシ	doll
シス	dolphin
シセ	domain
シソ	donate
シタ	donkey
シチ	donor
シツ	door
シテ	dose
シト	double
シナ	dove
シニ	draft
シヌ	dragon
シネ	drama
シノ	drastic
シハ	draw
シヒ	dream
シフ	dress
シヘ	drift
シホ	drill
シマ	drink
シミ	drip
シム	drive
シメ	drop
シモ	drum
シヤ	dry
シユ	duck
シヨ	dumb
シラ	dune
シリ	during
シル	dust
シレ	dutch
シロ	duty
シワ	dwarf
シヲ	dynamic
シン	eager
スア	eagle
スイ	early
スウ	earn
スエ	earth
スオ	easily
スカ	east
スキ	easy
スク	echo
スケ	ecology
スコ	economy
スサ	edge
スシ	edit
スス	educate
スセ	effort
スソ	egg
スタ	eight
スチ	either
スツ	elbow
ステ	elder
スト	electric
スナ	elegant
スニ	element
スヌ	elephant
スネ	elevator
スノ	elite
スハ	else
スヒ	embark
スフ	embody
スヘ	embrace
スホ	emerge
スマ	emotion
スミ	employ
スム	empower
スメ	empty
スモ	enable
スヤ	enact
スユ	end
スヨ	endless
スラ	endorse
スリ	enemy
スル	energy
スレ	enforce
スロ	engage
スワ	engine
スヲ	enhance
スン	enjoy
セア	enlist
セイ	enough
セウ	enrich
セエ	enroll
セオ	ensure
セカ	enter
セキ	entire
セク	entry
セケ	envelope
セコ	episode
セサ	equal
セシ	equip
セス	era
セセ	erase
セソ	erode
セタ	erosion
セチ	error
セツ	erupt
セテ	escape
セト	essay
セナ	essence
セニ	estate
セヌ	eternal
セネ	ethics
セノ	evidence
セハ	evil
セヒ	evoke
セフ	evolve
セヘ	exact
セホ	example
セマ	excess
セミ	exchange
セム	excite
セメ	exclude
セモ	excuse
セヤ	execute
セユ	exercise
セヨ	exhaust
セラ	exhibit
セリ	exile
セル	exist
セレ	exit
セロ	exotic
セワ	expand
セヲ	expect
セン	expire
ソア	explain
ソイ	expose
ソウ	express
ソエ	extend
ソオ	extra
ソカ	eye
ソキ	eyebrow
ソク	fabric
ソケ	face
ソコ	faculty
ソサ	fade
ソシ	faint
ソス	faith
ソセ	fall
ソソ	false
ソタ	fame
ソチ	family
ソツ	famous
ソテ	fan
ソト	fancy
ソナ	fantasy
ソニ	farm
ソヌ	fashion
ソネ	fat
ソノ	fatal
ソハ	father
ソヒ	fatigue
ソフ	fault
ソヘ	favorite
ソホ	feature
ソマ	february
ソミ	federal
ソム	fee
ソメ	feed
ソモ	feel
ソヤ	female
ソユ	fence
ソヨ	festival
ソラ	fetch
ソリ	fever
ソル	few
ソレ	fiber
ソロ	fiction
ソワ	field
ソヲ	figure
ソン	file
タア	film
タイ	filter
タウ	final
タエ	find
タオ	fine
タカ	finger
タキ	finish
タク	fire
タケ	firm
タコ	first
タサ	fiscal
タシ	fish
タス	fit
タセ	fitness
タソ	fix
タタ	flag
タチ	flame
タツ	flash
タテ	flat
タト	flavor
タナ	flee
タニ	flight
タヌ	flip
タネ	float
タノ	flock
タハ	floor
タヒ	flower
タフ	fluid
タヘ	flush
タホ	fly
タマ	foam
タミ	focus
タム	fog
タメ	foil
タモ	fold
タヤ	follow
タユ	food
タヨ	foot
タラ	force
タリ	forest
タル	forget
タレ	fork
タロ	fortune
タワ	forum
タヲ	forward
タン	fossil
チア	foster
チイ	found
チウ	fox
チエ	fragile
チオ	frame
チカ	frequent
チキ	fresh
チク	friend
チケ	fringe
チコ	frog
チサ	front
チシ	frost
チス	frown
チセ	frozen
チソ	fruit
チタ	fuel
チチ	fun
チツ	funny
チテ	furnace
チト	fury
チナ	future
チニ	gadget
チヌ	gain
チネ	galaxy
チノ	gallery
チハ	game
チヒ	gap
チフ	garage
チヘ	garbage
チホ	garden
チマ	garlic
チミ	garment
チム	gas
チメ	gasp
チモ	gate
チヤ	gather
チユ	gauge
チヨ	gaze
チラ	general
チリ	genius
チル	genre
チレ	gentle
チロ	genuine
チワ	gesture
チヲ	ghost
チン	giant
ツア	gift
ツイ	giggle
ツウ	ginger
ツエ	giraffe
ツオ	girl
ツカ	give
ツキ	glad
ツク	glance
ツケ	glare
ツコ	glass
ツサ	glide
ツシ	glimpse
ツス	globe
ツセ	gloom
ツソ	glory
ツタ	glove
ツチ	glow
ツツ	glue
ツテ	goat
ツト	goddess
ツナ	gold
ツニ	good
ツヌ	goose
ツネ	gorilla
ツノ	gospel
ツハ	gossip
ツヒ	govern
ツフ	gown
ツヘ	grab
ツホ	grace
ツマ	grain
ツミ	grant
ツム	grape
ツメ	grass
ツモ	gravity
ツヤ	great
ツユ	green
ツヨ	grid
ツラ	grief
ツリ	grit
ツル	grocery
ツレ	group
ツロ	grow
ツワ	grunt
ツヲ	guard
ツン	guess
テア	guide
テイ	guilt
テウ	guitar
テエ	gun
テオ	gym
テカ	habit
テキ	hair
テク	half
テケ	hammer
テコ	hamster
テサ	hand
テシ	happy
テス	harbor
テセ	hard
テソ	harsh
テタ	harvest
テチ	hat
テツ	have
テテ	hawk
テト	hazard
テナ	head
テニ	health
テヌ	heart
テネ	heavy
テノ	hedgehog
テハ	height
テヒ	hello
テフ	helmet
テヘ	help
テホ	hen
テマ	hero
テミ	hidden
テム	high
テメ	hill
テモ	hint
テヤ	hip
テユ	hire
テヨ	history
テラ	hobby
テリ	hockey
テル	hold
テレ	hole
テロ	holiday
テワ	hollow
テヲ	home
テン	honey
トア	hood
トイ	hope
トウ	horn
トエ	horror
トオ	horse
トカ	hospital
トキ	host
トク	hotel
トケ	hour
トコ	hover
トサ	hub
トシ	huge
トス	human
トセ	humble
トソ	humor
トタ	hundred
トチ	hungry
トツ	hunt
トテ	hurdle
トト	hurry
トナ	hurt
トニ	husband
トヌ	hybrid
トネ	ice
トノ	icon
トハ	idea
トヒ	identify
トフ	idle
トヘ	ignore
トホ	ill
トマ	illegal
トミ	illness
トム	image
トメ	imitate
トモ	immense
トヤ	immune
トユ	impact
トヨ	impose
トラ	improve
トリ	impulse
トル	inch
トレ	include
トロ	income
トワ	increase
トヲ	index
トン	indicate
ナア	indoor
ナイ	industry
ナウ	infant
ナエ	inflict
ナオ	inform
ナカ	inhale
ナキ	inherit
ナク	initial
ナケ	inject
ナコ	injury
ナサ	inmate
ナシ	inner
ナス	innocent
ナセ	input
ナソ	inquiry
ナタ	insane
ナチ	insect
ナツ	inside
ナテ	inspire
ナト	install
ナナ	intact
ナニ	interest
ナヌ	into
ナネ	invest
ナノ	invite
ナハ	involve
ナヒ	iron
ナフ	island
ナヘ	isolate
ナホ	issue
ナマ	item
ナミ	ivory
ナム	jacket
ナメ	jaguar
ナモ	jar
ナヤ	jazz
ナユ	jealous
ナヨ	jeans
ナラ	jelly
ナリ	jewel
ナル	job
ナレ	join
ナロ	joke
ナワ	journey
ナヲ	joy
ナン	judge
ニア	juice
ニイ	jump
ニウ	jungle
ニエ	junior
ニオ	junk
ニカ	just
ニキ	kangaroo
ニク	keen
ニケ	keep
ニコ	ketchup
ニサ	key
ニシ	kick
ニス	kid
ニセ	kidney
ニソ	kind
ニタ	kingdom
ニチ	kiss
ニツ	kit
ニテ	kitchen
ニト	kite
ニナ	kitten
ニニ	kiwi
ニヌ	knee
ニネ	knife
ニノ	knock
ニハ	know
ニヒ	lab
ニフ	label
ニヘ	labor
ニホ	ladder
ニマ	lady
ニミ	lake
ニム	lamp
ニメ	language
ニモ	laptop
ニヤ	large
ニユ	later
ニヨ	latin
ニラ	laugh
ニリ	laundry
ニル	lava
ニレ	law
ニロ	lawn
ニワ	lawsuit
ニヲ	layer
ニン	lazy
ヌア	leader
ヌイ	leaf
ヌウ	learn
ヌエ	leave
ヌオ	lecture
ヌカ	left
ヌキ	leg
ヌク	legal
ヌケ	legend
ヌコ	leisure
ヌサ	lemon
ヌシ	lend
ヌス	length
ヌセ	lens
ヌソ	leopard
ヌタ	lesson
ヌチ	letter
ヌツ	level
ヌテ	liar
ヌト	liberty
ヌナ	library
ヌニ	license
ヌヌ	life
ヌネ	lift
ヌノ	light
ヌハ	like
ヌヒ	limb
ヌフ	limit
ヌヘ	link
ヌホ	lion
ヌマ	liquid
ヌミ	list
ヌム	little
ヌメ	live
ヌモ	lizard
ヌヤ	load
ヌユ	loan
ヌヨ	lobster
ヌラ	local
ヌリ	lock
ヌル	logic
ヌレ	lonely
ヌロ	long
ヌワ	loop
ヌヲ	lottery
ヌン	loud
ネア	lounge
ネイ	love
ネウ	loyal
ネエ	lucky
ネオ	luggage
ネカ	lumber
ネキ	lunar
ネク	lunch
ネケ	luxury
ネコ	lyrics
ネサ	machine
ネシ	mad
ネス	magic
ネセ	magnet
ネソ	maid
ネタ	mail
ネチ	main
ネツ	major
ネテ	make
ネト	mammal
ネナ	man
ネニ	manage
ネヌ	mandate
ネネ	mango
ネノ	mansion
ネハ	manual
ネヒ	maple
ネフ	marble
ネヘ	march
ネホ	margin
ネマ	marine
ネミ	market
ネム	marriage
ネメ	mask
ネモ	mass
ネヤ	master
ネユ	match
ネヨ	material
ネラ	math
ネリ	matrix
ネル	matter
ネレ	maximum
ネロ	maze
ネワ	meadow
ネヲ	mean
ネン	measure
ノア	meat
ノイ	mechanic
ノウ	medal
ノエ	media
ノオ	melody
ノカ	melt
ノキ	member
ノク	memory
ノケ	mention
ノコ	menu
ノサ	mercy
ノシ	merge
ノス	merit
ノセ	merry
ノソ	mesh
ノタ	message
ノチ	metal
ノツ	method
ノテ	middle
ノト	midnight
ノナ	milk
ノニ	million
ノヌ	mimic
ノネ	mind
ノノ	minimum
ノハ	minor
ノヒ	minute
ノフ	miracle
ノヘ	mirror
ノホ	misery
ノマ	miss
ノミ	mistake
ノム	mix
ノメ	mixed
ノモ	mixture
ノヤ	mobile
ノユ	model
ノヨ	modify
ノラ	mom
ノリ	moment
ノル	monitor
ノレ	monkey
ノロ	monster
ノワ	month
ノヲ	moon
ノン	moral
ハア	more
ハイ	morning
ハウ	mosquito
ハエ	mother
ハオ	motion
ハカ	motor
ハキ	mountain
ハク	mouse
ハケ	move
ハコ	movie
ハサ	much
ハシ	muffin
ハス	mule
ハセ	multiply
ハソ	muscle
ハタ	museum
ハチ	mushroom
ハツ	music
ハテ	must
ハト	mutual
ハナ	myself
ハニ	mystery
ハヌ	myth
ハネ	naive
ハノ	name
ハハ	napkin
ハヒ	narrow
ハフ	nasty
ハヘ	nation
ハホ	nature
ハマ	near
ハミ	neck
ハム	need
ハメ	negative
ハモ	neglect
ハヤ	neither
ハユ	nephew
ハヨ	nerve
ハラ	nest
ハリ	net
ハル	network
ハレ	neutral
ハロ	never
ハワ	news
ハヲ	next
ハン	nice
ヒア	night
ヒイ	noble
ヒウ	noise
ヒエ	nominee
ヒオ	noodle
ヒカ	normal
ヒキ	north
ヒク	nose
ヒケ	notable
ヒコ	note
ヒサ	nothing
ヒシ	notice
ヒス	novel
ヒセ	now
ヒソ	nuclear
ヒタ	number
ヒチ	nurse
ヒツ	nut
ヒテ	oak
ヒト	obey
ヒナ	object
ヒニ	oblige
ヒヌ	obscure
ヒネ	observe
ヒノ	obtain
ヒハ	obvious
ヒヒ	occur
ヒフ	ocean
ヒヘ	october
ヒホ	odor
ヒマ	off
ヒミ	offer
ヒム	office
ヒメ	often
ヒモ	oil
ヒヤ	okay
ヒユ	old
ヒヨ	olive
ヒラ	olympic
ヒリ	omit
ヒル	once
ヒレ	one
ヒロ	onion
ヒワ	online
ヒヲ	only
ヒン	open
フア	opera
フイ	opinion
フウ	oppose
フエ	option
フオ	orange
フカ	orbit
フキ	orchard
フク	order
フケ	ordinary
フコ	organ
フサ	orient
フシ	original
フス	orphan
フセ	ostrich
フソ	other
フタ	outdoor
フチ	outer
フツ	output
フテ	outside
フト	oval
フナ	oven
フニ	over
フヌ	own
フネ	owner
フノ	oxygen
フハ	oyster
フヒ	ozone
フフ	pact
フヘ	paddle
フホ	page
フマ	pair
フミ	palace
フム	palm
フメ	panda
フモ	panel
フヤ	panic
フユ	panther
フヨ	paper
フラ	parade
フリ	parent
フル	park
フレ	parrot
フロ	party
フワ	pass
フヲ	patch
フン	path
ヘア	patient
ヘイ	patrol
ヘウ	pattern
ヘエ	pause
ヘオ	pave
ヘカ	payment
ヘキ	peace
ヘク	peanut
ヘケ	pear
ヘコ	peasant
ヘサ	pelican
ヘシ	pen
ヘス	penalty
ヘセ	pencil
ヘソ	people
ヘタ	pepper
ヘチ	perfect
ヘツ	permit
ヘテ	person
ヘト	pet
ヘナ	phone
ヘニ	photo
ヘヌ	phrase
ヘネ	physical
ヘノ	piano
ヘハ	picnic
ヘヒ	picture
ヘフ	piece
ヘヘ	pig
ヘホ	pigeon
ヘマ	pill
ヘミ	pilot
ヘム	pink
ヘメ	pioneer
ヘモ	pipe
ヘヤ	pistol
ヘユ	pitch
ヘヨ	pizza
ヘラ	place
ヘリ	planet
ヘル	plastic
ヘレ	plate
ヘロ	play
ヘワ	please
ヘヲ	pledge
ヘン	pluck
ホア	plug
ホイ	plunge
ホウ	poem
ホエ	poet
ホオ	point
ホカ	polar
ホキ	pole
ホク	police
ホケ	pond
ホコ	pony
ホサ	pool
ホシ	popular
ホス	portion
ホセ	position
ホソ	possible
ホタ	post
ホチ	potato
ホツ	pottery
ホテ	poverty
ホト	powder
ホナ	power
ホニ	practice
ホヌ	praise
ホネ	predict
ホノ	prefer
ホハ	prepare
ホヒ	present
ホフ	pretty
ホヘ	prevent
ホホ	price
ホマ	pride
ホミ	primary
ホム	print
ホメ	priority
ホモ	prison
ホヤ	private
ホユ	prize
ホヨ	problem
ホラ	process
ホリ	produce
ホル	profit
ホレ	program
ホロ	project
ホワ	promote
ホヲ	proof
ホン	property
マア	prosper
マイ	protect
マウ	proud
マエ	provide
マオ	public
マカ	pudding
マキ	pull
マク	pulp
マケ	pulse
マコ	pumpkin
マサ	punch
マシ	pupil
マス	puppy
マセ	purchase
マソ	purity
マタ	purpose
マチ	purse
マツ	push
マテ	put
マト	puzzle
マナ	pyramid
マニ	quality
マヌ	quantum
マネ	quarter
マノ	question
マハ	quick
マヒ	quit
マフ	quiz
マヘ	quote
マホ	rabbit
ママ	raccoon
マミ	race
マム	rack
マメ	radar
マモ	radio
マヤ	rail
マユ	rain
マヨ	raise
マラ	rally
マリ	ramp
マル	ranch
マレ	random
マロ	range
マワ	rapid
マヲ	rare
マン	rate
ミア	rather
ミイ	raven
ミウ	raw
ミエ	razor
ミオ	ready
ミカ	real
ミキ	reason
ミク	rebel
ミケ	rebuild
ミコ	recall
ミサ	receive
ミシ	recipe
ミス	record
ミセ	recycle
ミソ	reduce
ミタ	reflect
ミチ	reform
ミツ	refuse
ミテ	region
ミト	regret
ミナ	regular
ミニ	reject
ミヌ	relax
ミネ	release
ミノ	relief
ミハ	rely
ミヒ	remain
ミフ	remember
ミヘ	remind
ミホ	remove
ミマ	render
ミミ	renew
ミム	rent
ミメ	reopen
ミモ	repair
ミヤ	repeat
ミユ	replace
ミヨ	report
ミラ	require
ミリ	rescue
ミル	resemble
ミレ	resist
ミロ	resource
ミワ	response
ミヲ	result
ミン	retire
ムア	retreat
ムイ	return
ムウ	reunion
ムエ	reveal
ムオ	review
ムカ	reward
ムキ	rhythm
ムク	rib
ムケ	ribbon
ムコ	rice
ムサ	rich
ムシ	ride
ムス	ridge
ムセ	rifle
ムソ	right
ムタ	rigid
ムチ	ring
ムツ	riot
ムテ	ripple
ムト	risk
ムナ	ritual
ムニ	rival
ムヌ	river
ムネ	road
ムノ	roast
ムハ	robot
ムヒ	robust
ムフ	rocket
ムヘ	romance
ムホ	roof
ムマ	rookie
ムミ	room
ムム	rose
ムメ	rotate
ムモ	rough
ムヤ	round
ムユ	route
ムヨ	royal
ムラ	rubber
ムリ	rude
ムル	rug
ムレ	rule
ムロ	run
ムワ	runway
ムヲ	rural
ムン	sad
メア	saddle
メイ	sadness
メウ	safe
メエ	sail
メオ	salad
メカ	salmon
メキ	salon
メク	salt
メケ	salute
メコ	same
メサ	sample
メシ	sand
メス	satisfy
メセ	satoshi
メソ	sauce
メタ	sausage
メチ	save
メツ	say
メテ	scale
メト	scan
メナ	scare
メニ	scatter
メヌ	scene
メネ	scheme
メノ	school
メハ	science
メヒ	scissors
メフ	scorpion
メヘ	scout
メホ	scrap
メマ	screen
メミ	script
メム	scrub
メメ	sea
メモ	search
メヤ	season
メユ	seat
メヨ	second
メラ	secret
メリ	section
メル	security
メレ	seed
メロ	seek
メワ	segment
メヲ	select
メン	sell
モア	seminar
モイ	senior
モウ	sense
モエ	sentence
モオ	series
モカ	service
モキ	session
モク	settle
モケ	setup
モコ	seven
モサ	shadow
モシ	shaft
モス	shallow
モセ	share
モソ	shed
モタ	shell
モチ	sheriff
モツ	shield
モテ	shift
モト	shine
モナ	ship
モニ	shiver
モヌ	shock
モネ	shoe
モノ	shoot
モハ	shop
モヒ	short
モフ	shoulder
モヘ	shove
モホ	shrimp
モマ	shrug
モミ	shuffle
モム	shy
モメ	sibling
モモ	sick
モヤ	side
モユ	siege
モヨ	sight
モラ	sign
モリ	silent
モル	silk
モレ	silly
モロ	silver
モワ	similar
モヲ	simple
モン	since
ヤア	sing
ヤイ	siren
ヤウ	sister
ヤエ	situate
ヤオ	six
ヤカ	size
ヤキ	skate
ヤク	sketch
ヤケ	ski
ヤコ	skill
ヤサ	skin
ヤシ	skirt
ヤス	skull
ヤセ	slab
ヤソ	slam
ヤタ	sleep
ヤチ	slender
ヤツ	slice
ヤテ	slide
ヤト	slight
ヤナ	slim
ヤニ	slogan
ヤヌ	slot
ヤネ	slow
ヤノ	slush
ヤハ	small
ヤヒ	smart
ヤフ	smile
ヤヘ	smoke
ヤホ	smooth
ヤマ	snack
ヤミ	snake
ヤム	snap
ヤメ	sniff
ヤモ	snow
ヤヤ	soap
ヤユ	soccer
ヤヨ	social
ヤラ	sock
ヤリ	soda
ヤル	soft
ヤレ	solar
ヤロ	soldier
ヤワ	solid
ヤヲ	solution
ヤン	solve
ユア	someone
ユイ	song
ユウ	soon
ユエ	sorry
ユオ	sort
ユカ	soul
ユキ	sound
ユク	soup
ユケ	source
ユコ	south
ユサ	space
ユシ	spare
ユス	spatial
ユセ	spawn
ユソ	speak
ユタ	special
ユチ	speed
ユツ	spell
ユテ	spend
ユト	sphere
ユナ	spice
ユニ	spider
ユヌ	spike
ユネ	spin
ユノ	spirit
ユハ	split
ユヒ	spoil
ユフ	sponsor
ユヘ	spoon
ユホ	sport
ユマ	spot
ユミ	spray
ユム	spread
ユメ	spring
ユモ	spy
ユヤ	square
ユユ	squeeze
ユヨ	squirrel
ユラ	stable
ユリ	stadium
ユル	staff
ユレ	stage
ユロ	stairs
ユワ	stamp
ユヲ	stand
ユン	start
ヨア	state
ヨイ	stay
ヨウ	steak
ヨエ	steel
ヨオ	stem
ヨカ	step
ヨキ	stereo
ヨク	stick
ヨケ	still
ヨコ	sting
ヨサ	stock
ヨシ	stomach
ヨス	stone
ヨセ	stool
ヨソ	story
ヨタ	stove
ヨチ	strategy
ヨツ	street
ヨテ	strike
ヨト	strong
ヨナ	struggle
ヨニ	student
ヨヌ	stuff
ヨネ	stumble
ヨノ	style
ヨハ	subject
ヨヒ	submit
ヨフ	subway
ヨヘ	success
ヨホ	such
ヨマ	sudden
ヨミ	suffer
ヨム	sugar
ヨメ	suggest
ヨモ	suit
ヨヤ	summer
ヨユ	sun
ヨヨ	sunny
ヨラ	sunset
ヨリ	super
ヨル	supply
ヨレ	supreme
ヨロ	sure
ヨワ	surface
ヨヲ	surge
ヨン	surprise
ラア	surround
ライ	survey
ラウ	suspect
ラエ	sustain
ラオ	swallow
ラカ	swamp
ラキ	swap
ラク	swarm
ラケ	swear
ラコ	sweet
ラサ	swift
ラシ	swim
ラス	swing
ラセ	switch
ラソ	sword
ラタ	symbol
ラチ	symptom
ラツ	syrup
ラテ	system
ラト	table
ラナ	tackle
ラニ	tag
ラヌ	tail
ラネ	talent
ラノ	talk
ラハ	tank
ラヒ	tape
ラフ	target
ラヘ	task
ラホ	taste
ラマ	tattoo
ラミ	taxi
ラム	teach
ラメ	team
ラモ	tell
ラヤ	ten
ラユ	tenant
ラヨ	tennis
ララ	tent
ラリ	term
ラル	test
ラレ	text
ラロ	thank
ラワ	that
ラヲ	theme
ラン	then
リア	theory
リイ	there
リウ	they
リエ	thing
リオ	this
リカ	thought
リキ	three
リク	thrive
リケ	throw
リコ	thumb
リサ	thunder
リシ	ticket
リス	tide
リセ	tiger
リソ	tilt
リタ	timber
リチ	time
リツ	tiny
リテ	tip
リト	tired
リナ	tissue
リニ	title
リヌ	toast
リネ	tobacco
リノ	today
リハ	toddler
リヒ	toe
リフ	together
リヘ	toilet
リホ	token
リマ	tomato
リミ	tomorrow
リム	tone
リメ	tongue
リモ	tonight
リヤ	tool
リユ	tooth
リヨ	top
リラ	topic
リリ	topple
リル	torch
リレ	tornado
リロ	tortoise
リワ	toss
リヲ	total
リン	tourist
ルア	toward
ルイ	tower
ルウ	town
ルエ	toy
ルオ	track
ルカ	trade
ルキ	traffic
ルク	tragic
ルケ	train
ルコ	transfer
ルサ	trap
ルシ	trash
ルス	travel
ルセ	tray
ルソ	treat
ルタ	tree
ルチ	trend
ルツ	trial
ルテ	tribe
ルト	trick
ルナ	trigger
ルニ	trim
ルヌ	trip
ルネ	trophy
ルノ	trouble
ルハ	truck
ルヒ	true
ルフ	truly
ルヘ	trumpet
ルホ	trust
ルマ	truth
ルミ	try
ルム	tube
ルメ	tuition
ルモ	tumble
ルヤ	tuna
ルユ	tunnel
ルヨ	turkey
ルラ	turn
ルリ	turtle
ルル	twelve
ルレ	twenty
ルロ	twice
ルワ	twin
ルヲ	twist
ルン	two
レア	type
レイ	typical
レウ	ugly
レエ	umbrella
レオ	unable
レカ	unaware
レキ	uncle
レク	uncover
レケ	under
レコ	undo
レサ	unfair
レシ	unfold
レス	unhappy
レセ	uniform
レソ	unique
レタ	unit
レチ	universe
レツ	unknown
レテ	unlock
レト	until
レナ	unusual
レニ	unveil
レヌ	update
レネ	upgrade
レノ	uphold
レハ	upon
レヒ	upper
レフ	upset
レヘ	urban
レホ	urge
レマ	usage
レミ	use
レム	used
レメ	useful
レモ	useless
レヤ	usual
レユ	utility
レヨ	vacant
レラ	vacuum
レリ	vague
レル	valid
レレ	valley
レロ	valve
レワ	van
レヲ	vanish
レン	vapor
ロア	various
ロイ	vast
ロウ	vault
ロエ	vehicle
ロオ	velvet
ロカ	vendor
ロキ	venture
ロク	venue
ロケ	verb
ロコ	verify
ロサ	version
ロシ	very
ロス	vessel
ロセ	veteran
ロソ	viable
ロタ	vibrant
ロチ	vicious
ロツ	victory
ロテ	video
ロト	view
ロナ	village
ロニ	vintage
ロヌ	violin
ロネ	virtual
ロノ	virus
ロハ	visa
ロヒ	visit
ロフ	visual
ロヘ	vital
ロホ	vivid
ロマ	vocal
ロミ	voice
ロム	void
ロメ	volcano
ロモ	volume
ロヤ	vote
ロユ	voyage
ロヨ	wage
ロラ	wagon
ロリ	wait
ロル	walk
ロレ	wall
ロロ	walnut
ロワ	want
ロヲ	warfare
ロン	warm
ワア	warrior
ワイ	wash
ワウ	wasp
ワエ	waste
ワオ	water
ワカ	wave
ワキ	way
ワク	wealth
ワケ	weapon
ワコ	wear
ワサ	weasel
ワシ	weather
ワス	web
ワセ	wedding
ワソ	weekend
ワタ	weird
ワチ	welcome
ワツ	west
ワテ	wet
ワト	whale
ワナ	what
ワニ	wheat
ワヌ	wheel
ワネ	when
ワノ	where
ワハ	whip
ワヒ	whisper
ワフ	wide
ワヘ	width
ワホ	wife
ワマ	wild
ワミ	will
ワム	win
ワメ	window
ワモ	wine
ワヤ	wing
ワユ	wink
ワヨ	winner
ワラ	winter
ワリ	wire
ワル	wisdom
ワレ	wise
ワロ	wish
ワワ	witness
ワヲ	wolf
ワン	woman
ヲア	wonder
ヲイ	wood
ヲウ	wool
ヲエ	word
ヲオ	work
ヲカ	world
ヲキ	worry
ヲク	worth
ヲケ	wrap
ヲコ	wreck
ヲサ	wrestle
ヲシ	wrist
ヲス	write
ヲセ	wrong
ヲソ	yard
ヲタ	year
ヲチ	yellow
ヲツ	you
ヲテ	young
ヲト	youth
ヲナ	zebra
ヲニ	zero
ヲヌ	zone
ヲネ	zoo
